NO textures/north_n.xpm
SO textures/sud_n.xpm
WE textures/west_n.xpm
EA textures/est_n.xpm
F 0,0,255
C 100,100,100
1111111111111111111
1000000000000000011
1010101010101010111
1000000000000000011
1101010101010101011
100000000000000011
100001000000000E011
1000000000000000011
1000000000000000011
1000000011000000011
1000000000000000011
1000000000000000011
1000111000000000011
1000100000000000011
1000101000010000011
1000111000000000011
1000000000000000011
1111111111111111111
