NO textures/north.xpm
SO textures/south.xpm
WE textures/west.xpm
EA textures/east.xpm
F 0,220,100
C 30,20,10
1111111111111111111
1000000000000000011
1010101010101010111
1000000000000000011
1101010101010101011
100000000000000011
100001000000000N011
1000000000000000011
1000000000000000011
1000000000000000011
1111111111111111111
