NO textures/north.xpm
SO textures/south.xpm
WE textures/west.xpm
EA textures/east.xpm
F 0,220,100
C 225,30,0
        1111111111111111111111111
        1000000000110000000000001
        1011000001110000000000001
        1001000000000000000000001
111111111011000001110000000000001           1
100000000011000001110111111111111
11110111111111011100000010001
11110111111111011101010010001
110000001101010111001 1010001
10000000000000001100010010001
10000000000000001101010010001
11000001110101011111111110N0111
11110111 1110101        101111011
1111111 1111111        111111111111
1
