NO textures/north.xpm
SO textures/south.xpm
WE textures/west.xpm
EA textures/east.xpm
F 0,220,100
C 225,30,0
11111111111
10000000011
1010000N011
10000000011
10000000011
10000100011
10000000011
10000000011
10000000011
11111111111
